
turn away   : reject/refuse/deny
turn down   : reject/refuse/deny
put forward : propose
level off   : steady/plateau
way above   : far above / much higher than
shoot up    : sharply rise / rapidly increase
put forward : propose
fix up      : ready for
go at       : quarrel

maturity    : mature ripe
saturation  : saturate sufficient/full
pronounced  : pronounce clearly/distinctly
elaborate   : expound
inferior    : lower
informed    : inform sensible/advisable
pilot       : try
abysmal     : terrible/deep
renowned    : renown famous/noted
ponder      : think
plummet     : slump/fall/decline
wield       : wave/exert
bar         : barred hinder/obstruct
ethic       : moral/virtue
ethnic      : nation
rule out    : exclude/preclude/remove/refrain
attractions : viewpoint
apron       : pinafore
vibe        : air/atmosphere
censor      : review/examine
chill       : relax/rest
vision      : beauty
stink       : bad/terrible
decompose   : resolve/rotting

in due course   : timely
blue chips      : blue stock

L/C         : letter of credit
sales rep   : the representative of selling
icebreaking : icebreaking exercises
next door   : neighbor
fire up     : startup/turn on
hang in     : persist/insist/adhere to
come along  : appear/emerge/show up
puke to     : vomit/throw up
stumble upon    : occasional encounter/discover
license plate   : car's license plate

chump                       : 笨蛋
pinhead                     : 猪头
presto                      : 神奇吧
lead on                     : 引诱/欺骗感情/误导
about to                    : 将要..
heads up                    : 当心
I'm fried                   : 我脑子很乱
fire away                   : 尽管问
no can do                   : 不能/做不到
get a say                   : 有发言权
night out                   : 夜生活
caller ID                   : 来电显示 
good point                  : 说得好
sign me up                  : 算我一个
warm up to                  : 对..开始有好感
go over to                  : 去
I'll get it                 : 我来开门/接电话
I could use                 : 我想..
blow .. off                 : 放鸽子
in the zone                 : 正进入状态
be raised in                : 长大
get the door                : 开/关门
watch closely               : 看仔细了
the lesson is               : 教训就是
it never ends               : 没完没了
I've got time               : 我有时间
where were we               : 刚说到哪了
poop pee fart               : 屎尿屁
hang out with               : 和..出去玩
brace yourself              : 做好准备
safe and sound              : 安然无恙
how's it going              : 你好吗/你怎么样了
that's my ride              : 接我的车来了
give it a shot              : 给个机会
for the record              : 声明一下
stand a chance              : 有机会
take one's time             : 慢慢来/别着急
put it this way             : 换句话说
shoot some hoop             : 投篮
not much of a n.            : 不怎么会../算不上
didn't bother to            : 懒得..
in a position to            : 有能力..
what have we here           : 这都是些啥
I'm all about the           : 都是为了..
save it for later           : 留到后面
while we're at it           : 那就顺便..
feel the same way           : 想的一样/一样的想法
you look familiar           : 你看起来很眼熟
I'll give you that          : 我承认这点
get this over with          : 把这事做完
knock yourself out          : 请自便/你自己去吧
hold out your hand          : 手伸出来
we're getting there         : 快好了/快到了
can you help me out         : 能帮帮我吗
know better than to         : 不至于/蠢到
for crying out loud         : 搞什么名堂/天呐够了
pull one over on sb         : 欺骗某人
learned the hard way        : 吃了苦头才懂的
I'm leaving for work        : 我去上班了
get out of your hair        : 不打扰你了
have a lot in common        : 有很多共同点
running on a schedule       : 正按计划进行
that's what .. is for       : 就是..的作用
it's all in your head       : 都是你想象出来的
just out of curiosity       : 出于好奇
didn't see that coming      : 没想到会这样
save the best for last      : 压轴
it's all taken care of      : 都搞定了
We've been through this     : 我们说过这事了
under any circumstances     : 在任何情况下
kick/take it up a notch     : 提升到更高水平/提档
somewhere along the way     : 在这过程中(某刻)
let one's freak flag fly    : 放飞自我
running behind a schedule   : 进度落后
get this all under control  : 尽在掌控之中
what seems to be the problem        : 出了什么问题
just because .. doesn't mean ..     : ..并不代表..
don't take this the wrong way       : 别误解 没别的意思
eating sb out of house and home     : 把某人吃穷
couldn't have said it better myself : 说不了比这更好
